#F######
#.#...##
#.#.#..#
#...##.#
#####..# 
#S##..##
#....###
###.####
###.####
###.####
###.####
###.####
########