#F#######
#.###...#
#.#...#.#
#...##..#
#####.#.#
#S##..#.#
#.......#
#########